20
20
KHDCDHKHCDHKCDHKHCHK
HDHKHDHKHDHCKHKDHKDH
DKHCHKHDKHDHCHKDHCHK
HDKHDHKDHCHKDHKDHCKH
DHKDHKDHKDHCHKDHKDHD
KHDKHDHCHDCKDCKDHDKH
KHDCDHKHCDHKCDHKHCHK
HDHKHDHKHDHCKHKDHKDH
DKHCHKHDKHDHCHKDHCHK
HDKHDHKDHCHKDHKDHCKH
DHKDHKDHKDHCHKDHKDHD
KHDKHDHCHDCKDCKDHDKH
KHDCDHKHCDHKCDHKHCHK
HDHKHDHKHDHCKHKDHKDH
DKHCHKHDKHDHCHKDHCHK
HDKHDHKDHCHKDHKDHCKH
DHKDHKDHKDHCHKDHKDHD
KHDKHDHCHDCKDCKDHDKH
KHDCDHKHCDHKCDHKHCHK
HDHKHDHKHDHCKHKDHKDH
DKHCHKHDKHDHCHKDHCHK